BBBBBBBBBBBBBBBBBBBBBBBBBBBBBBBBBBBBBBBBBBBBBBBB
GGGGGGGGGGGGGGGGGGGGGGGGGGGGGGG!%GGGGGGGGGGGGGGB
GGGBGGGGTGGGGGGGGGGGBGGGGGGGGGG"$GGGGGGGGGGGGGGB
1111111FE1111111137777713111111111111111111GGGGB
1666666666666680000000000010000000000008661GGGGB
1666666666666680000000000010000000000008661GGGGB
166331111111111C000000000030000000000001661GGGGB
1663440044004410000000000030000000000001661GGGGB
1661000000000000000000000070000000000001661GGGGB
166100000000C000000000000070000000000201668GGGGB
166100000000000000000000001C000000000001668GGGGB
1663311111111110000000000011111111111131661GGGGB
1556666666666610000000000016666666666666551GGGGB
1556666666666610000000000016666666666666551GGGGB
1663311111118810000000000018811111111133661GGGGB
16630000000C0010000000000010000000000CTE661GGGGB
166302000000007000000000007000000000020F661GGGGB
1661000000000070000000000070000000000001661GGGGB
1661000000000010000000000010000000000001661GGGGB
1661000000000010000000000030000000000001661GGGGB
166100000000001000000000001000TC00000001661GGGGB
166111317713111131777771331111AF1111111166117711
1661000000000010000000000000000000JL000166800001
1661000000000010000000000000000000KM000166800001
166AT0000000001000000000000000000000000866100001
166F00000000001000000000000000000000000866120021
166100000000001002000000000000000000000111100001
16680000JL00001000000000000000000000000000000001
16680000KM00001000000000000000000000000000000001
111111111111111111111111111111111111111111111111