BBBBBBBBBBBBBBBBBBBBBBBBBBBBBBBBBBBBBBBBBBBBBBBB
BGGGGGGGGGGGGGGGGGGGGGGGGGGGGGG!%GGGGGGGGGGGGGGB
BGGGGGGGGGGGGGGGGGGGGGGGGGGGGGG"$GGGGGGGGGGGGGGB
BGGGGGGGGGGGGGGGGGGGGGGGGGGGGGGGGGGGGGGGGGGGGGGB
YRRYYYY11ll1111111111111111111188111111111111111
BGGGGGG1000000^000022000000000166100000000000000
BGGGGGG1000000^+^^^^^^^^^00000166100000000000000
BGGGGGG1-00000000000000000000*166100000000000000
BGGGGGG1-00000000000000000000*166100000000000000
BGGGGGG1-00000000000000000000*166100000000000000
BGGGGGG10000000000000000000000166100000000000000
BGGGGGG10000000000000000000000155100000000000000
BGGGGGG1-00000000000000000000*155100000000000000
BGGGGGG1-00000000000000000000*166100000000000000
BGGGGGG1-00000000000000000000*166100000000000000
BGGGGGG10000000000000000000044166100000000000000
BGGGGGG30000000000000000000000866100000000000000
BGGGGGG300000000000000000000008661G0000000000000
BGGGGGG33311111111111111111111111111111111111111
BGGGGGGGGGGGGGGGGGGGGGGGGGGGGGGGGGGGGGGGGGGGGGGB
BBBBBGGGGGGGGGBBGGGGGGGGGGGGGGGGGGGGGGGGGGGGGGGB
BBBBBBGCGGGGGGGGGGGGGGGGGGGGGGGGGGGGGGGGGGGGGGGB
BBBBBBBGGGGGGBBGGGGGGGGPUGGGGGGGGGGGGGGGGGGGGGBB
BBBBBBBGGGGGGGGGGGGGGGGXOGGGGGGGGGGGGGGGGGGGBBBB
BBBBBBBBGGGGGGGGGGGGGGGGGGGGGGGGGGGGGGGGGGGBBBBB
BBBBBBBBBGGGGCGGGGGGGGGGGGGGGGGGGGGGGGGGBBBBBBBB
BBBBBBBBBBGGGGGGGGGGGGGGGGGGGGGGGGGGGGGBBBBBBBBB
BBBBBBBBBBBGGGGGGGGGGGGGGGGGGGGGGGGGGBBBBBBBBBBB
BBBBBBBBBBBBGGGGGGGGGGGGGGGGGGGGGGGBBBBBBBBBBBBB
BBBBBBBBBBBBBBBBBBBBBBBBBBBBBBBBBBBBBBBBBBBBBBBB